1111111111111111111111111111111111111111111111
1000000000000000000E0011000000000000000000E001
100000000E0000000000001100000000E00000P0000001
110000000CC000000000001110000000CC000000000001
1000000000000000000E0011000000000000000000E001
1000000000000000000E0000000000000000000000E001
100000000E0000000000000000000000E0000000000001
110000000CC000000000001110000000CC000000000001
1000000000000000000E0011000000000000000000E001
1000000000000000000E0011000000000000000000E001
100000000E0000000000001100000000E0000000000001
1111111111111111111111111111111111111111111111