11111111111111111111111111111111
10000001000010000000000000000001
10000001111000000000000000000001
100000000E1000000000000000000001
100000000110000000000P0000000001
1000000111100000C000000000000001
10000000000000000000000000000001
11111111111111111111111111111111