11111111111111111111111
1000000000000000000E001
100000000E00000P0000001
110000000CC000000000001
110000000CC000000000001
110000000CC000000000001

1000000000000000000E001
100000000E0000000000001
110000000CC00000000E001
11111111111111111001111
100000*0000000000000001
11111111111111111111111