11111111111111111111111
1000000000000000000E001
100000000E00000P0000001
110000000CC000000000001
11111111111111111111111