11111111111111111111111111111111
10000001000010000000000000000001
10000001111000000000000000000001
100000000E10000000000000P0000001
10000000011000000000000000000001
100000011110000000000C0000P00001
10000000000000000000000000000001
11111111111111111111111111111111