11111111111111111111111111111111
10000001000010000000000000000001
10C00001111000000000000000000001
100000000E1000000000000000000001
10000000011000000000000000000001
10000001111000000000000000000001
100P0000000000000000000000000001
11111111111111111111111111111111
