11111111111111111111111111111111
10000001000010000000000000000001
10000001111000000000000000000001
100000000E10000000000000P0000001
1000000001100000000000x000000001
100000011110000000000C0000000001
10000000000000000000000000000001
11111111111111111111111111111111