11111111111111111111111
10000000000000000000001
100000000E00000P0000001
100000000000000C0000001
11111111111111111111111